11111111111111111
1e011001000101011
11001101110001011
11100100110111011
10001100000000001
10111111111001111
10011101000101111
11000000011101111
11011001011101111
11011011011101111
10000000000000001
111111111111111m1
11111111111111111
