111111
100011
e01001
111101
1m0001
101111
111111
